11111111111111111111111111111
10E1000000C00000C000000000000
11110100000101001000000010101
10010101010001001000000010101
1P00C00C0000000000000000000C1
11111111111111111111111111111