1111111111111111111111111111111111
100001000000000C10000C0100E0100001
1010010100100100101001010000110001
1010010010101010001001010000011111
1P0001000000C0000000000000000000C1
1111111111111111111111111111111111