11111111111111111111111111111
10E1000000C00000C000000000001
11110100000101001000000010101
10010101010001001000000010101
1P00C00C0000000000000000000C1
11111111111111111111111111111

1111111111111111111111111111111111
1111111122122222121221222222212111
1112111100100000101001000000010111
1112111110101010001001000000010111
1111111212121212221221222222212111
1111111111111111111111111111111111