111111
1P00C1
101001
101001
1000E1
111111